################################################################################
#...........##..............................................######.............#
#...........##..............................................######.............#
#...........##...................###########...................................#
#...........##...................###########...................................#
#...........##...................###########...................................#
#...........##...................###########...................................#
#...........##...................###########................#######............#
#...........................................................#######............#
#...........................................................#######............#
#...........................................................#######............#
#............................##.............................#######............#
#...........########..........##................###################............#
#...........########...........##...............###################............#
#...............####............##..............###################............#
#...............####.............##.............###################............#
#...............#########.........##...........................................#
#...............#########..........##..........................................#
#...................................##.........................................#
#....................................##........................##..............#
#.....................................##......................##...............#
#......................................##....................##................#
#..........##########...................##..................##.................#
#..........##########....................##................###########.........#
#..........##########.....................................##...................#
#..........##########....................................##....................#
#..........##########...................................##.....................#
#.................###......................................................#####
#.................###.......................................................+++#
################################################################################
