################################################################################
#......##......##......##......##......##......##......##......##.........#+++##
#......##......##......##......##..............##......##......##..##.....#....#
#......##......##......##......##..............##......##......##..##..........#
#......##......##......##......##..............##......##......##..............#
#......##......##......##......##......##......##..............##..............#
#......##..............##......##......##......##..............##..##......#####
#......##..............##......##......##......##..............##..##......##..#
#......##..............##......##......##......##......##......##..............#
#......##......##......##......##......##......##......##......##..#....##.....#
#......##......##......##......##......##......##......##......##.......##.....#
#......##......##......##......##......##......##......##......##..............#
#......##......##......##..............##......##......##......##..##....##....#
#......##......##......##..............##......##......##......##..##....##....#
#......##......##......##..............##......##......##......##..............#
#......##......##......##......##......##......##......##......##..#...##......#
#......##......##......##......##......##......##......##......##..#...##......#
#......##......##......##......##......##......##......##......##..............#
#......##......##......##......##......##......##......##......##....##....##..#
#......##......##......##......##......##......##......##......##....##....##..#
#......##......##......##......##......##......##......##......##..............#
#......##......##......##......##......##......##......##......##..............#
#......##......##......##......##......##......##......##......................#
#..............##......##......##......##......##......##......................#
#..............##......##......##......##......##......##.............####.....#
#..............##......##......##......##..............##......##.....####.....#
#......##......##..............##......##..............##.............####.....#
#......##......##..............##......##..............##......##..............#
#......##......##..............##......##......##......##......##..............#
################################################################################