################################################################################
#..............................................................................#
#..............................................................................#
#..................................................................#...........#
#..................................................................#...........#
#..................................................................#...........#
#..................................................................#...........#
#..................................................................#...........#
#..................................................................#...........#
#..................................................................#...........#
#..................................................................#...........#
#..................................................................#...........#
#..................................................................#......######
#..................................................................#......######
#.........##########################################################........+++#
#..................................................................#......######
#..................................................................#......######
#..................................................................#...........#
#..................................................................#...........#
#..................................................................#...........#
#..................................................................#...........#
#..................................................................#...........#
#..................................................................#...........#
#..................................................................#...........#
#..................................................................#...........#
#..................................................................#...........#
#..................................................................#...........#
#..............................................................................#
#..............................................................................#
################################################################################