################################################################################
#                                                                              #
#                                                                              #
#                                                                              #
#                                                                              #
#                                                                              #
#                                                                              #
#                                                                              #
#                                                                              #
#                                                                              #
#                                                                              #
#                                                                              #
#                                                                              #
#                                   LEVEL 3                                    #
#                                   SURVIVE                                    #
#                                PRESS ANY KEY                                 #
#                                                                              #
#                                                                              #
#                                                                              #
#                                                                              #
#                                                                              #
#                                                                              #
#                                                                              #
#                                                                              #
#                                                                              #
#                                                                              #
#                                                                              #
#                                                                              #
#                                                                              #
#                                                                              #
################################################################################